Name:level1 Time:50000 SpawnRate:5000 Boss:0
xxxxxxxxxsssxxxxxxxxx
x...................x
x...................x
x...................x
x...................x
x...................x
x...................x
x...................x
x...................x
s...................s
s.........p.........s
s...................s
x...................x
x...................x
x...................x
x...................x
x...................x
x...................x
x...................x
x...................x
xxxxxxxxxsssxxxxxxxxx

Name:level2 Time:50000 SpawnRate:4000 Boss:0
xxxxxxxxxsssxxxxxxxxx
x...................x
x...................x
x...................x
x...................x
x....xxx.....xxx....x
x....x.........x....x
x....x.........x....x
x...................x
s...................s
s.........p.........s
s...................s
x...................x
x....x.........x....x
x....x.........x....x
x....xxx.....xxx....x
x...................x
x...................x
x...................x
x...................x
xxxxxxxxxsssxxxxxxxxx

Name:level3 Time:50000 SpawnRate:3000 Boss:0
xxxxxxxxxsssxxxxxxxxx
x...................x
x...................x
x..x.............x..x
x...................x
x....s.xx...xx.s....x
x...................x
x....x.........x....x
x....x.........x....x
s........b..........s
s.........p.........s
s...................s
x....x.........x....x
x....x.........x....x
x...................x
x....s.xx...xx.s....x
x...................x
x..x.............x..x
x...................x
x...................x
xxxxxxxxxsssxxxxxxxxx